13 13 13 13 13 13 13 13 13 13 13 13 13 13 13 13 13 13 13 13 13 13 13 13 13 13 13 13 13 13 13 13 13 13 13 13 13 13 13 13 13 13 13 13 13 13 13 13 13 13
13 1 1 1 1 1 1 1 1 1 1 1 1 1 1 1 1 1 1 1 1 1 1 1 1 1 1 1 1 1 1 1 1 1 1 1 1 1 1 1 1 1 1 1 1 1 1 1 1 13
13 1 1 1 1 1 1 1 1 1 1 1 1 1 1 1 1 1 1 1 1 1 1 1 1 1 1 1 1 1 1 1 1 1 1 1 1 1 1 1 1 1 1 1 1 1 1 1 1 13
13 14 14 14 14 14 14 14 14 14 14 14 14 14 14 14 14 14 14 14 14 14 14 14 14 14 14 14 14 14 14 14 14 14 14 14 14 14 14 14 14 14 14 14 14 14 14 14 14 13
13 3 3 3 3 3 3 3 3 3 3 3 3 3 3 3 3 3 3 3 3 3 3 3 3 3 3 3 3 3 3 3 3 3 3 3 3 3 3 3 3 3 3 3 3 3 3 3 3 13
13 14 14 14 14 14 14 14 14 14 14 14 14 14 14 14 14 14 14 14 14 14 14 14 14 14 14 14 14 14 14 14 14 14 14 14 14 14 14 14 14 14 14 14 14 14 14 14 14 13
13 1 1 1 1 1 1 1 1 1 1 1 1 14 14 14 1 1 1 1 1 1 14 14 14 14 1 1 1 14 14 1 14 1 1 1 1 1 14 14 1 1 1 1 1 1 1 1 1 13
13 1 1 1 1 1 1 1 1 1 1 1 1 14 14 14 1 1 1 1 1 1 1 14 14 14 1 1 1 14 14 1 14 1 1 1 1 1 14 14 14 1 1 1 1 1 1 1 1 13
13 1 1 1 1 1 1 1 1 1 1 1 14 14 14 14 1 1 1 1 1 1 1 14 14 14 1 1 1 1 14 1 14 1 1 1 1 1 14 14 14 14 1 1 1 1 1 1 1 13
13 1 1 1 1 1 1 1 1 1 1 1 14 14 14 1 1 1 1 1 1 1 1 14 14 14 1 1 1 1 14 14 14 14 1 1 1 1 1 14 14 14 14 1 1 1 1 1 1 13
13 1 1 1 1 1 1 1 1 1 1 1 14 14 1 1 1 1 1 1 1 1 1 1 14 14 14 1 1 1 1 1 14 14 1 1 1 1 1 1 14 14 14 14 1 1 1 1 1 13
13 1 1 1 1 1 1 1 1 1 1 14 14 14 1 1 1 1 1 1 1 1 1 1 14 16 16 16 16 16 1 1 14 14 1 1 1 1 1 1 1 14 14 14 14 1 1 1 1 13
13 1 1 1 1 1 1 1 1 1 14 14 14 1 1 1 1 1 1 1 1 1 1 16 16 16 16 16 16 16 16 16 14 14 14 1 1 1 1 1 1 1 14 14 14 1 1 1 1 13
13 1 1 1 1 1 1 1 1 1 14 14 14 1 1 1 1 1 1 1 1 1 1 16 16 16 16 16 16 16 16 16 16 16 14 1 1 1 1 1 1 1 14 14 14 1 1 1 1 13
13 1 1 1 1 1 1 1 1 14 14 14 1 1 1 1 1 1 1 1 1 1 16 16 16 16 16 16 16 16 16 16 16 16 14 14 14 1 1 1 1 1 14 14 14 1 1 1 1 13
13 1 1 1 1 1 1 1 1 14 14 14 1 1 1 1 1 1 1 1 1 16 16 16 16 16 16 16 16 16 16 16 16 16 14 14 14 1 1 1 1 1 14 14 14 1 1 1 13 13
13 1 1 1 1 1 1 1 14 14 14 1 1 1 1 1 1 1 1 1 1 16 16 16 16 16 16 16 16 16 16 16 16 16 16 14 14 1 1 1 1 1 1 14 14 14 1 4 13 13
13 1 1 1 1 1 1 1 14 14 14 1 1 1 1 1 1 1 1 1 1 16 16 16 16 16 16 16 16 16 16 16 16 16 1 14 14 1 1 1 1 1 1 14 14 14 14 13 13 13
13 1 1 1 1 1 1 1 14 14 14 1 1 1 1 1 1 1 1 1 1 1 1 16 16 16 16 16 16 16 16 16 16 1 1 14 14 1 1 1 1 1 1 1 14 14 14 14 14 15
13 1 1 1 1 1 1 14 14 14 1 1 1 1 1 1 1 1 1 1 1 1 1 1 16 16 16 16 16 16 16 16 1 1 1 14 14 1 1 1 1 1 1 1 1 1 14 14 14 13
13 1 1 1 1 1 1 14 14 14 1 1 1 1 1 1 1 1 1 1 1 1 1 1 1 1 16 16 1 1 1 1 1 1 1 14 14 1 1 1 1 1 1 1 1 1 13 13 13 13
13 1 1 1 1 1 1 14 14 14 1 1 1 1 1 1 1 1 1 1 1 1 1 14 1 1 1 1 1 14 1 1 1 1 1 14 14 1 1 1 1 1 1 1 1 1 1 13 13 13
13 1 1 1 1 1 1 1 14 14 14 1 1 1 1 1 1 1 1 1 1 1 1 14 1 1 1 1 14 1 1 1 1 1 1 14 14 1 1 1 1 1 1 1 1 1 1 13 13 13
13 1 1 1 1 1 1 1 14 14 14 1 1 1 1 1 1 1 1 1 1 1 1 1 14 1 1 1 14 1 1 1 1 1 1 14 14 1 1 1 1 1 1 1 1 1 1 1 4 13
13 1 1 1 1 1 1 1 14 14 14 14 1 1 1 1 1 1 1 1 1 1 1 14 14 14 14 14 14 1 1 1 1 1 1 14 14 1 1 1 1 1 1 1 1 1 1 1 13 13
13 1 1 1 1 1 1 1 1 14 14 14 1 1 1 1 1 1 1 1 1 1 14 1 1 1 1 1 1 14 1 1 1 1 1 14 14 1 1 1 1 1 1 1 1 1 1 1 1 13
13 1 1 1 1 1 1 1 1 14 14 14 1 1 1 1 1 1 1 1 1 14 1 1 14 1 1 14 1 1 14 1 1 1 1 14 14 14 1 1 1 1 1 1 1 1 1 1 1 13
13 1 1 1 1 1 1 1 1 14 14 14 1 1 1 1 1 1 1 1 1 14 1 1 1 1 1 1 1 1 14 1 1 1 1 14 14 14 14 1 1 1 1 1 1 1 1 1 1 13
13 1 1 1 1 1 1 1 1 14 14 14 1 1 1 1 1 1 1 1 1 1 14 1 3 3 3 3 1 14 1 1 1 1 1 1 14 14 14 1 1 1 1 1 1 1 1 1 1 13
13 1 1 1 1 1 1 1 1 14 14 14 1 1 1 1 1 1 1 1 1 1 1 14 1 1 1 1 14 1 1 1 1 1 1 1 1 14 14 14 1 1 1 1 1 1 1 1 1 13
13 1 1 1 1 1 1 1 1 14 14 14 1 1 1 1 1 1 1 1 1 1 1 14 14 14 14 14 1 1 1 1 1 1 1 1 1 1 14 14 14 1 1 1 1 1 1 1 1 13
13 1 1 1 1 1 1 1 1 14 14 14 1 1 1 1 1 1 1 1 1 1 1 1 1 1 1 1 1 1 1 1 1 1 1 1 1 1 1 14 14 1 1 1 1 1 1 1 1 13
13 12 12 12 1 1 1 1 1 14 14 14 1 1 1 1 1 1 1 1 1 1 1 1 1 1 1 1 1 1 1 1 1 1 1 1 1 12 12 14 14 14 14 14 14 14 14 1 1 13
13 12 12 12 12 12 12 1 14 14 14 14 1 1 1 1 1 1 1 1 1 1 1 1 1 1 1 1 1 1 1 1 1 1 1 12 12 12 12 12 14 14 14 14 14 14 14 14 14 13
13 12 12 12 12 12 12 12 14 14 14 14 1 1 1 1 1 1 1 1 1 1 1 1 1 1 1 1 1 1 1 12 12 12 12 12 12 12 12 12 12 12 12 12 12 12 14 14 14 13
13 5 5 5 5 5 12 12 14 14 14 14 12 12 12 12 12 12 12 12 12 12 12 12 12 12 12 12 12 12 12 12 12 12 12 5 5 5 5 5 5 5 5 5 5 12 12 12 12 13
13 16 16 16 16 16 5 12 14 14 14 14 12 12 12 12 12 12 12 5 5 5 5 5 12 12 12 12 12 12 5 5 5 5 5 16 16 16 16 16 16 16 16 16 16 5 5 5 5 13
13 16 16 16 16 16 16 5 14 14 14 14 12 12 12 12 12 5 5 16 16 16 16 16 5 5 12 12 5 5 16 16 16 16 16 16 16 16 16 16 16 16 16 16 16 16 16 16 16 13
13 16 16 16 16 16 16 16 14 14 14 14 5 5 5 5 5 16 16 16 16 16 16 16 16 16 5 5 16 16 16 16 16 16 16 16 16 16 16 16 16 16 16 16 16 16 16 16 16 13
13 16 16 16 16 16 16 16 14 14 14 14 13 16 16 16 16 16 16 16 16 16 16 16 16 16 16 16 16 16 16 16 16 16 16 16 16 16 16 16 16 16 16 16 16 16 16 16 16 13
13 16 16 16 16 16 16 16 14 14 14 14 16 16 16 16 16 16 16 16 16 16 16 16 16 16 16 16 16 16 16 16 16 16 16 16 16 16 16 16 16 16 16 16 16 16 16 16 16 13
13 16 16 16 16 16 16 16 14 14 14 14 13 16 16 16 16 16 16 16 16 16 16 16 16 16 16 16 16 16 16 16 16 16 16 16 16 16 16 16 16 16 16 16 16 16 16 16 16 13
13 16 16 16 16 16 16 16 14 14 14 14 16 16 16 16 16 16 16 16 16 16 16 16 16 16 16 16 16 16 16 16 16 16 16 16 16 16 16 16 16 16 16 16 16 16 16 16 16 13
13 16 16 16 16 16 16 16 14 14 14 14 13 16 16 16 16 16 16 16 16 16 16 16 16 16 16 16 16 16 16 16 16 16 16 16 16 16 16 16 16 16 16 16 16 16 16 16 16 13
13 16 16 16 16 16 16 16 16 16 16 16 16 16 16 16 16 16 16 16 16 16 16 16 16 16 16 16 16 16 16 16 16 16 16 16 16 16 16 16 16 16 16 16 16 16 16 16 16 13
13 16 16 16 16 16 16 16 16 16 16 16 16 16 16 16 16 16 16 16 16 16 16 16 16 16 16 16 16 16 16 16 16 16 16 16 16 16 16 16 16 16 16 16 16 16 16 16 16 13
13 16 16 16 16 16 16 16 16 16 16 16 16 16 16 16 16 16 16 16 16 16 16 16 16 16 16 16 16 16 16 16 16 16 16 16 16 16 16 16 16 16 16 16 16 16 16 16 16 13
13 16 16 16 16 16 16 16 16 16 16 16 16 16 16 16 16 16 16 16 16 16 16 16 16 16 16 16 16 16 16 16 16 16 16 16 16 16 16 16 16 16 16 16 16 16 16 16 16 13
13 16 16 16 16 16 16 16 16 16 16 16 16 16 16 16 16 16 16 16 16 16 16 16 16 16 16 16 16 16 16 16 16 16 16 16 16 16 16 16 16 16 16 16 16 16 16 16 16 13
13 13 13 13 13 13 13 13 13 13 13 13 13 13 13 13 13 13 13 13 13 13 13 13 13 13 13 13 13 13 13 13 13 13 13 13 13 13 13 13 13 13 13 13 13 13 13 13 13 13
