13 13 13 13 13 13 13 13 13 13 13 13 13 13 13 13 13 13 13 13 13 13 13 13 13 13 13 13 13 13 13 13 13 13 13 13 13 13 13 13 13 13 13 13 13 13 13 13 13 13
13 0 0 0 0 11 0 2 2 2 2 2 2 2 2 2 2 2 2 2 2 2 2 2 2 2 2 2 2 0 0 11 0 0 0 0 0 0 0 14 14 16 16 16 16 16 16 16 16 13
13 0 0 0 0 2 2 2 2 2 2 11 2 2 2 2 2 2 11 2 2 2 0 0 2 2 2 2 2 0 0 0 0 0 11 0 0 0 0 0 14 16 16 16 16 16 16 16 16 13
13 0 0 0 2 2 2 2 2 2 11 0 0 2 2 2 2 2 2 2 2 11 0 0 2 0 2 2 0 0 0 0 0 0 0 0 0 11 0 0 14 14 14 14 14 14 16 16 16 13
13 0 0 0 0 2 2 2 2 2 2 0 0 0 2 2 2 2 2 2 2 0 0 0 0 0 2 2 0 11 0 11 0 0 0 0 0 11 0 0 0 0 0 0 0 14 14 16 16 13
13 0 0 0 0 0 0 2 2 2 2 11 2 0 2 2 2 2 2 0 11 11 0 0 0 0 0 0 0 0 0 0 0 0 0 0 0 0 0 0 0 11 11 0 0 0 14 14 16 13
13 0 0 0 0 11 0 2 2 2 2 2 2 2 2 2 2 0 0 0 0 0 0 0 0 0 0 0 11 0 0 0 2 2 2 0 0 0 0 0 0 0 0 0 0 0 0 14 14 13
13 0 0 0 0 0 0 2 2 2 2 2 2 2 2 2 2 2 0 0 0 0 0 0 0 0 0 0 0 0 0 0 0 2 2 0 0 11 0 0 0 0 0 0 0 0 0 0 11 13
13 0 0 0 0 0 0 0 2 2 2 2 0 0 0 2 2 2 2 2 0 0 0 0 0 0 0 0 11 0 0 0 2 2 2 2 0 0 0 0 0 0 0 0 0 0 11 0 0 13
13 0 0 0 0 0 0 0 2 11 2 2 2 0 0 0 2 2 2 2 0 0 0 11 0 0 0 0 0 0 0 0 2 2 2 2 2 0 0 0 11 0 0 0 11 0 0 0 0 13
13 0 0 0 0 11 0 0 2 2 2 2 2 0 2 2 2 2 2 2 2 0 0 0 0 11 0 0 0 0 0 0 2 2 2 2 2 0 0 0 0 11 0 0 0 0 0 0 0 13
13 0 0 0 0 0 0 0 2 2 2 2 2 0 2 2 2 2 2 2 0 0 0 0 0 0 0 0 0 11 0 0 2 2 2 2 0 0 0 0 0 0 0 0 0 0 0 0 2 13
13 0 0 0 0 0 0 0 0 2 2 2 2 0 0 0 0 0 0 0 0 0 0 0 0 0 0 0 0 0 0 0 0 2 2 2 2 11 0 0 0 0 0 0 11 0 0 2 2 13
13 0 0 0 0 0 0 0 0 2 2 2 2 0 0 0 11 0 0 0 0 11 0 11 0 0 0 0 0 0 0 0 0 0 2 2 2 0 0 0 0 11 0 0 0 0 2 2 2 13
13 0 0 0 11 0 0 0 0 0 2 2 2 2 0 0 0 0 0 0 0 0 0 0 0 0 0 0 0 0 0 0 0 0 2 2 2 0 11 0 0 0 0 0 0 0 2 2 2 13
13 0 0 0 0 0 0 11 0 0 0 2 2 2 0 0 0 0 0 0 0 0 0 0 0 0 0 0 0 11 0 11 0 0 2 2 2 0 0 0 0 0 11 0 0 2 2 2 2 13
13 16 0 0 0 0 0 0 0 0 0 2 2 2 0 0 0 0 11 0 0 0 0 0 0 11 0 0 0 0 0 0 0 0 0 0 0 0 11 0 0 0 11 0 2 2 2 2 0 13
13 16 0 0 0 0 0 0 0 0 0 0 2 2 0 0 0 0 0 0 0 0 0 0 0 11 0 0 0 0 0 0 11 0 0 0 0 0 11 0 0 0 0 0 2 2 2 0 0 13
13 16 16 16 0 0 0 0 11 0 0 0 2 2 0 0 0 0 0 0 0 0 11 0 0 0 0 0 0 0 0 0 0 0 0 0 11 0 0 0 11 0 0 2 2 2 0 0 0 13
13 16 16 16 16 0 0 0 0 0 0 0 2 2 2 0 0 0 11 0 0 0 0 0 0 0 11 0 0 11 0 0 0 0 0 0 0 0 0 0 0 0 0 2 2 11 0 11 0 13
13 16 16 16 16 16 0 0 0 0 0 0 2 2 2 0 0 0 0 0 0 11 0 0 0 0 0 0 0 0 0 0 0 0 11 0 0 0 11 0 0 0 2 2 2 2 0 0 0 13
13 16 16 16 16 16 16 0 0 0 0 0 0 2 2 2 0 0 0 0 0 0 0 14 0 0 0 0 0 14 0 0 0 0 0 0 0 0 0 0 0 0 2 2 2 2 0 0 0 13
13 16 16 16 16 16 16 16 0 0 0 14 0 2 2 2 0 0 0 0 0 0 0 14 0 0 0 0 14 0 0 0 0 0 0 0 0 0 0 0 0 0 2 2 2 0 0 11 0 13
13 0 16 16 16 16 16 16 16 0 14 14 14 2 2 2 0 0 11 0 0 0 0 0 14 0 0 0 14 0 0 11 0 0 0 11 0 0 11 11 0 0 2 11 2 0 0 0 0 13
13 0 0 16 16 16 16 16 16 16 14 14 14 14 2 2 2 0 0 0 0 0 0 14 14 14 14 14 14 0 0 0 0 0 0 0 0 0 0 0 0 0 2 2 2 0 0 0 0 13
13 0 0 16 16 16 16 16 16 16 14 14 14 14 2 2 2 2 2 2 0 0 14 11 0 0 11 0 0 14 0 0 0 0 11 0 0 0 0 0 0 0 2 2 2 0 0 0 11 13
13 0 0 0 16 16 16 16 16 14 14 14 14 14 2 2 2 2 2 2 2 14 0 0 14 0 0 14 0 0 14 0 0 0 0 0 0 0 11 0 0 0 2 2 2 11 0 0 0 13
13 0 0 0 0 16 16 16 16 14 14 14 14 14 16 16 0 2 2 2 2 14 0 0 11 0 0 0 0 0 14 0 0 0 0 0 0 0 0 0 11 2 2 2 2 0 0 0 0 13
13 0 0 0 0 16 16 16 14 14 14 14 14 16 16 16 16 16 0 0 0 0 14 0 3 3 3 3 11 14 0 0 0 0 0 11 0 0 0 0 0 2 2 2 2 0 11 0 0 13
13 0 0 0 0 0 16 16 14 14 14 14 16 16 16 16 16 16 16 0 0 0 0 14 0 0 11 0 14 0 0 0 0 0 11 0 0 0 0 0 2 2 0 2 2 0 0 11 0 13
13 0 0 0 0 0 0 14 14 14 14 14 16 16 16 16 16 16 16 16 0 0 0 14 14 14 14 14 0 0 0 0 0 0 0 0 0 0 0 0 2 2 2 2 2 0 0 0 0 13
13 0 0 0 0 0 0 14 14 14 14 16 16 16 16 16 16 16 16 16 16 16 0 0 0 0 0 0 0 0 0 0 0 0 0 0 0 0 0 2 2 2 2 2 0 0 0 0 0 13
13 0 0 0 0 0 0 0 14 14 14 16 16 16 16 16 16 16 16 16 16 16 16 0 0 0 0 11 0 0 0 11 0 0 0 0 0 0 2 2 0 2 2 0 0 11 0 0 0 13
13 0 0 0 0 0 0 0 0 0 0 0 0 16 16 16 16 16 16 16 16 16 16 0 0 0 0 0 0 0 0 0 0 0 0 0 0 2 2 2 2 2 2 2 0 0 0 0 0 13
13 0 0 0 0 0 0 0 11 0 0 0 0 0 0 16 16 16 16 16 16 16 16 16 0 0 0 0 11 0 0 0 0 0 0 0 2 2 2 2 2 2 2 0 0 11 0 0 0 13
13 0 0 0 0 0 0 0 0 0 0 0 0 0 0 0 0 16 16 16 16 16 16 16 0 0 0 0 0 11 0 0 0 0 0 2 2 11 2 2 2 0 0 0 0 0 11 11 0 13
13 0 0 0 0 11 0 0 0 0 0 0 11 0 0 0 0 16 16 16 16 16 16 16 16 0 0 0 0 0 0 0 0 2 2 2 2 2 0 2 0 11 0 0 11 0 0 0 11 13
13 0 0 0 0 0 0 0 11 0 0 11 0 0 0 0 0 0 16 16 16 16 16 16 16 2 2 2 2 2 2 2 2 2 2 2 2 2 2 2 0 0 0 11 0 0 0 0 11 13
13 0 0 0 0 0 0 0 0 0 0 0 0 0 0 11 0 0 16 16 16 16 16 16 16 2 0 2 2 2 11 2 2 2 2 2 2 2 2 0 11 0 0 0 0 0 11 0 11 13
13 0 0 0 0 0 11 0 0 0 0 0 0 0 0 0 0 0 16 16 16 16 16 16 16 2 2 2 2 2 2 2 2 2 0 0 0 0 11 0 0 0 0 0 0 0 0 0 11 13
13 0 0 0 0 0 0 0 0 0 0 11 0 0 11 0 0 0 2 16 16 16 16 16 16 0 0 0 0 0 0 0 0 0 0 0 0 0 0 0 0 14 14 3 14 0 0 11 0 13
13 0 0 0 0 0 0 0 0 0 0 0 0 0 0 0 0 0 2 16 16 16 16 16 16 0 0 0 0 0 0 0 0 0 0 0 0 0 0 14 14 14 14 14 14 14 14 0 13 13
13 0 0 0 0 0 0 0 0 0 0 0 0 0 0 11 0 0 2 16 16 16 16 16 16 0 0 0 11 0 0 0 11 0 0 0 0 0 0 14 3 14 0 14 0 3 14 13 13 13
13 0 0 0 0 11 0 0 0 11 0 0 0 0 0 0 0 0 2 16 16 16 16 16 16 16 0 0 0 0 0 0 0 0 0 0 0 0 14 14 14 3 14 14 14 14 13 4 13 13
13 0 0 0 0 0 0 0 0 0 0 0 0 0 0 14 14 14 14 16 16 16 16 16 16 16 0 0 0 0 0 0 0 0 0 0 0 0 3 14 3 11 14 3 11 3 13 13 4 13
13 0 0 0 0 0 11 0 0 0 0 0 0 0 14 14 14 14 14 14 14 14 14 14 14 14 14 14 14 0 0 0 0 0 0 0 0 0 14 14 14 14 14 0 14 14 4 13 4 13
13 0 0 0 11 0 0 0 0 0 0 2 2 2 14 14 14 14 14 14 14 14 14 14 14 14 14 14 14 0 0 11 0 0 0 0 11 0 0 14 3 14 13 4 14 14 15 13 13 13
13 0 0 0 0 0 0 0 2 2 2 2 2 2 16 14 14 14 14 14 14 14 14 14 14 14 14 14 14 0 0 0 0 0 0 0 0 0 0 11 14 13 13 4 13 4 13 13 13 13
13 0 0 0 0 0 2 2 11 2 2 2 16 16 16 16 16 16 16 16 16 16 16 16 16 16 0 0 0 0 0 0 0 0 0 0 0 0 0 14 14 13 13 13 13 4 13 13 4 13
13 13 13 13 13 13 13 13 13 13 13 13 13 13 13 13 13 13 13 13 13 13 13 13 13 13 13 13 13 13 13 13 13 13 13 13 13 13 13 13 13 13 13 13 13 4 13 13 13 13
