13 13 13 13 13 13 13 13 13 13 13 13 13 13 13 13 13 13 13 13 13 13 13 13 13 13 13 13 13 13 13 13 13 13 13 13 13 13 13 13 13 13 13 13 13 13 13 13 13 13
13 14 14 13 14 14 13 14 14 14 14 13 13 14 14 14 14 14 14 14 13 13 14 14 14 14 14 14 14 14 14 14 14 14 13 14 14 14 14 14 14 14 13 14 14 14 14 14 14 13
13 14 14 13 14 14 13 14 14 14 14 14 13 14 14 14 14 14 14 14 14 13 13 14 14 14 14 14 14 14 13 13 14 14 13 14 14 14 14 14 14 14 13 14 14 14 14 14 14 13
13 14 14 13 14 14 13 14 13 14 14 13 13 13 14 14 14 14 14 14 14 14 14 13 13 13 13 13 13 13 13 13 13 14 13 13 14 14 14 14 14 14 13 14 13 14 14 13 14 13
13 14 14 13 14 14 13 14 14 13 13 14 14 13 13 14 14 14 14 14 14 14 14 14 14 14 14 14 13 13 13 13 13 14 14 13 14 14 14 14 14 13 13 14 14 13 13 14 14 13
13 13 13 13 14 14 13 14 14 13 13 14 14 14 13 13 13 13 13 13 13 14 14 14 14 14 14 14 14 14 13 13 13 13 13 13 14 14 14 14 14 13 14 14 14 13 13 14 14 13
13 14 14 14 14 14 13 14 13 14 14 13 14 14 14 14 14 14 14 14 13 13 13 13 14 14 14 14 14 14 14 13 14 14 14 13 14 14 14 14 14 13 14 14 13 14 14 13 14 13
13 14 14 14 14 14 13 13 14 14 14 14 14 14 14 14 14 13 13 13 14 14 14 13 13 13 14 14 14 14 14 13 14 14 14 13 14 14 14 14 13 13 14 14 14 14 14 14 14 13
13 14 14 14 14 14 14 13 14 14 14 14 14 13 13 14 14 14 14 14 14 14 13 13 13 13 13 14 14 14 14 13 14 14 13 13 14 14 14 14 13 14 14 14 14 14 14 14 14 13
13 13 13 13 14 14 14 13 13 13 13 13 13 13 13 13 13 13 13 13 14 14 13 13 13 13 13 13 14 14 14 13 13 13 13 14 14 14 14 13 13 13 14 14 14 14 14 14 13 13
13 14 14 13 14 14 14 14 14 13 13 14 14 14 14 14 14 14 14 13 13 13 13 13 13 13 13 13 14 14 14 14 14 14 14 14 14 14 14 14 14 13 13 14 14 14 14 13 13 13
13 14 14 13 13 14 14 14 14 14 14 14 14 14 14 14 14 14 14 14 14 14 14 13 13 13 13 13 14 14 14 14 14 14 14 14 14 14 14 14 14 14 13 13 13 14 13 13 13 13
13 14 14 14 13 13 14 14 14 14 14 14 14 14 14 14 14 14 14 14 14 14 14 14 14 13 13 13 14 14 14 13 13 13 13 13 13 13 14 14 14 14 14 14 13 13 13 14 14 13
13 14 14 14 14 13 13 13 14 14 14 14 13 13 13 13 13 14 14 14 14 14 14 14 14 14 14 14 14 14 14 14 14 14 14 14 14 13 13 14 14 14 14 14 14 14 14 14 14 13
13 14 14 14 14 14 14 13 14 14 14 14 13 13 13 13 13 13 13 14 14 14 14 14 14 14 14 14 14 14 14 14 14 14 14 14 14 14 13 13 14 14 14 14 14 14 14 14 14 13
13 14 14 14 14 14 14 13 14 14 14 14 13 13 13 13 13 13 13 13 13 13 13 13 14 14 14 13 13 13 13 13 14 14 14 14 14 14 14 13 13 14 14 14 14 14 14 14 14 13
13 14 13 14 14 13 14 13 13 14 14 14 13 13 13 13 14 13 13 14 14 14 14 13 14 14 14 13 14 14 14 13 13 13 14 14 14 14 14 14 13 13 14 14 14 14 14 14 13 13
13 14 14 13 13 14 14 14 13 13 14 14 14 13 13 14 14 13 13 14 14 14 13 13 1 16 0 13 13 14 14 14 14 13 13 13 14 14 14 14 14 13 13 14 14 14 14 13 13 13
13 14 14 13 13 14 14 14 14 13 14 14 14 13 13 14 14 13 13 14 13 13 1 1 1 16 0 0 0 13 13 14 14 14 14 13 13 14 14 14 14 14 13 14 14 14 13 13 13 13
13 14 13 14 14 13 14 14 14 13 14 14 14 13 13 13 14 14 13 13 1 1 1 1 1 16 0 11 0 0 0 13 13 14 14 14 13 13 14 14 14 14 13 13 13 13 13 14 14 13
13 14 14 14 14 14 14 14 14 13 14 14 14 13 14 13 13 13 1 1 1 1 1 1 1 16 0 0 11 0 0 0 0 13 14 14 13 13 13 14 14 14 14 14 14 14 14 14 14 13
13 14 14 14 14 14 14 14 14 13 14 14 14 13 14 14 14 13 1 1 3 3 1 14 1 16 11 0 0 14 3 3 0 13 14 13 13 14 13 13 14 14 14 14 14 14 14 14 14 13
13 14 14 14 14 14 14 14 13 13 14 14 14 13 14 14 13 1 1 1 3 3 1 14 1 16 0 0 14 0 3 3 0 0 13 13 14 14 14 13 14 14 14 14 14 14 14 14 14 13
13 14 14 14 14 14 14 13 13 14 14 14 14 13 13 14 13 1 1 1 1 1 1 1 14 16 0 11 14 0 11 11 0 0 13 14 14 14 13 13 14 14 14 13 13 13 14 14 14 13
13 13 14 14 13 13 13 13 14 14 14 14 14 14 13 13 13 1 1 1 1 1 1 14 14 14 14 14 14 0 0 0 0 0 13 13 13 13 13 14 14 14 14 13 14 13 13 13 13 13
13 13 13 13 13 14 14 14 14 14 14 14 14 14 14 14 1 1 1 1 1 1 14 11 0 0 11 0 0 14 0 0 0 0 11 14 14 14 14 14 14 14 14 13 14 14 14 14 13 13
13 14 14 14 14 14 14 14 14 13 13 14 14 14 14 14 16 16 16 16 16 14 0 0 14 0 0 14 0 0 14 16 16 16 16 14 14 14 14 14 14 14 14 13 14 14 14 14 14 13
13 14 14 14 14 14 14 14 13 13 14 14 14 14 14 13 13 14 14 14 14 14 0 0 11 0 0 0 0 0 14 2 2 2 13 13 13 14 14 14 14 14 14 13 14 14 13 13 13 13
13 14 14 14 14 13 13 13 14 14 14 14 14 13 13 13 13 14 14 14 14 14 14 0 3 3 3 3 11 14 2 2 2 2 13 14 13 13 14 14 14 14 13 13 14 14 13 13 13 13
13 13 13 13 13 13 14 14 14 14 14 14 13 13 14 14 13 14 14 14 3 3 14 14 0 0 11 0 14 2 3 3 2 2 13 14 14 13 13 14 14 14 13 14 14 14 13 13 13 13
13 14 14 14 14 14 14 14 14 14 13 13 13 14 14 14 14 13 14 14 3 3 14 14 14 14 14 14 2 2 3 3 2 13 14 14 14 14 13 14 14 14 13 14 14 14 13 13 13 13
13 14 14 14 14 14 14 14 14 14 13 14 14 14 13 14 14 13 14 14 14 14 14 14 14 16 2 2 2 2 2 2 2 13 14 14 13 14 13 13 14 14 13 13 14 14 14 14 14 13
13 14 14 14 13 14 14 14 14 13 13 14 14 14 14 14 14 13 13 13 14 14 14 14 14 16 2 2 2 2 2 13 13 14 14 14 14 14 14 13 14 14 14 13 13 13 14 14 14 13
13 14 14 14 13 13 13 13 13 13 13 13 14 14 13 14 14 14 14 14 13 13 14 14 14 16 2 2 2 13 13 14 14 14 14 13 13 13 13 13 14 14 14 14 14 13 13 14 13 13
13 14 14 14 14 14 14 14 13 14 14 13 13 13 13 13 13 13 13 13 13 13 13 13 14 16 2 13 13 14 14 14 14 14 13 13 14 14 13 13 14 14 14 14 14 14 13 13 13 13
13 14 14 14 14 14 14 14 13 13 14 14 14 13 14 13 14 14 14 14 14 14 14 13 14 14 14 13 14 14 14 14 14 13 13 14 14 14 13 14 14 14 14 14 14 14 14 14 14 13
13 14 14 14 14 14 14 14 14 13 13 13 14 14 14 14 14 14 14 13 14 14 14 13 14 14 14 13 14 14 14 14 13 13 14 14 14 13 13 14 14 14 13 14 14 14 14 14 14 15
13 14 14 14 14 14 14 14 14 14 14 13 13 13 13 13 13 13 13 13 13 13 13 13 14 14 14 13 13 14 14 13 13 14 14 14 14 13 14 14 14 14 13 13 13 13 13 14 14 13
13 14 14 14 14 14 14 14 14 14 14 14 14 14 14 14 14 14 14 14 14 14 14 14 14 14 14 14 13 13 13 13 14 14 14 14 14 13 14 14 14 13 13 14 14 14 13 13 13 13
13 13 13 13 13 14 14 14 14 14 14 14 14 14 14 14 14 14 14 14 14 14 14 14 14 14 14 14 14 14 14 14 14 14 14 14 14 13 14 14 14 13 13 13 14 14 14 14 13 13
13 14 14 14 13 13 13 14 14 14 14 14 14 14 14 14 14 14 14 14 14 14 14 14 14 14 14 14 14 14 14 14 14 14 13 13 13 13 14 14 14 13 14 13 13 14 14 14 14 13
13 14 14 14 14 14 13 13 14 14 14 14 14 14 14 14 13 13 13 13 13 13 13 13 13 14 14 14 14 14 14 14 13 13 13 14 13 14 14 14 14 13 14 14 13 14 14 13 13 13
13 14 14 13 14 14 13 13 13 14 14 14 14 13 13 13 13 14 14 14 14 14 14 14 14 14 14 14 14 14 14 13 13 14 14 14 13 14 14 14 14 13 14 14 14 13 13 14 14 13
13 14 14 14 13 13 14 14 13 14 14 14 13 13 14 14 14 14 14 14 14 14 14 14 14 14 14 14 14 14 13 13 14 14 14 14 13 14 14 14 14 13 13 14 14 13 13 14 14 13
13 13 14 14 13 13 14 14 13 14 14 14 13 14 14 14 14 14 14 14 13 13 14 14 14 14 14 13 13 13 13 14 14 14 14 14 13 14 14 14 14 14 13 14 13 14 14 13 14 13
13 14 13 13 14 14 13 14 13 14 14 14 13 14 14 14 14 14 14 13 13 13 14 14 14 14 13 13 14 14 14 14 14 14 14 14 13 14 14 14 14 14 13 14 13 14 14 13 14 13
13 14 14 13 14 14 14 14 13 14 14 14 13 14 14 14 14 13 13 13 13 13 14 14 14 13 13 14 14 13 13 13 14 14 14 13 13 14 14 14 14 14 13 14 13 14 14 13 14 13
13 14 14 14 13 14 14 14 13 14 14 14 13 14 14 14 13 13 13 13 13 13 14 14 13 13 14 14 13 13 13 13 14 14 13 13 14 14 14 14 14 13 13 14 13 14 14 13 13 13
13 14 14 14 14 13 14 13 13 14 14 14 13 14 14 14 13 13 13 13 13 13 14 14 13 14 14 14 13 13 13 13 14 14 13 13 14 14 14 14 14 13 14 13 13 14 14 14 14 13
13 13 13 13 13 13 13 13 13 13 13 13 13 13 13 13 13 13 13 13 13 13 13 13 13 13 13 13 13 13 13 13 13 13 13 13 13 13 13 13 13 13 13 13 13 13 13 13 13 13
